COUNTRIES = {
	c:BLZ = {
		effect_starting_technology_tier_5_tech = yes
		effect_create_law_package = {
			headOfGovernment = administrative
			distributionOfPower = autocracy
			criminalJustice = arbitrary_justice
			centralization = unitary
			discrimination = supremacist
			churchAndState = religious_nationalism
			bureaucraticSystems = technocrats
			policing = secret_police
			nationalDefense = irregular_military
			economicSystem = decentralization
			tradePolicy = free_trade
			taxation = per_capita_based_taxation
			educationSystem = informal_schooling
			healthSystem = charity_health_system
			environmentalRegulations = no_environment_regulations
			corporateAffairs = corporate_friendly_policies
			nationalization = no_nationalization
			wmds = no_wmds
			freeSpeech = outlawed_dissent
			laborRights = no_workers_protections
			childrensRights = child_labor_allowed
			rightsOfWomen = legal_guardianship
			familyPlanning = no_family_planning
			welfare = no_welfare
			migration = selective_immigration
			biotech = unrestricted_human_testing
			recreationalDrugs = total_prohibition
		}
	}
}
